1111111111111111111111111111111111
100000000000C0000000000000E0000001
1000011111111111110000000000000001
1000C00000000000010000000000000001
100000000C000000000000000000000001
100000000000E000000111111100000001
100000P001000000000000000000000001
10000000110000000000C000000C000001
1000111110000000000000000000000001
1000010000C00000000000000000000001
10000100000000000000C0000000000001
1000000E00000000000000000000000001
1111111111111111111111111111111111
