1111111111
1E0000C0)1
1000P00001
1111111111
