11111111111111111111111111111
10000000000000000000000000001
1000000110000000000000P000001
100000000C0000111000000000001
100011000000C0111000000000001
1000E000011000000000000000001
100000000000000C0000000000001
11111111111111111111111111111
